la madrugada - l'aube
el escritorio - le bureau
el sotano - la cave
un docente - un enseignant
un plomero - un plombier
la cajera - la caissiere
el sacerdote - le pretre
eso - cela
este - celui-ci
aquel - ce
aquella - cette
cerveza - biere
mi hermano menor - mon petit frere
mi hermano mayor - mon grand frere
barato - bon marché
los rumbos - les directions
la senal - le signal
dar un paso - faire un pas
sobre todo - surtout
cual de todos - lequel
cualquier - n'importe
esa - celle-la
algo - quelque chose
recordar - rappeler
aun - encore
por supuesto - bien sur
caber - tenir
firmar - signer
entregar - livrer
culpar - accuser
tonelada - tonne
alguien - quelqu'un
varios - plusieurs
una tortura - un supplice
un cuaderno - un carnet
contestar - repondre
un genio - un genie
un borrador - un brouillon
sugerir - proposer
raro - bizarre
acontecimiento - evénement
llevar - apporter
una subasta - une enchère
todavia - cependant
entonces - ensuite
la cebolla - l'oignon
una campana - une cloche
siquiera - meme pas
la hacienda - l'exploitation agricole
un hogar - un foyer
a pesar de - malgres
carino - affection
la revista - le magazine
el juicio - le procès
descansar - se reposer
alcanzar - atteindre
el pensamiento - la pensée
exito - succès
la ausencia - l'absence
despertar - se réveiller
los alumnos - les élèves
el polvo - la poudre
la caja - la boite
el pavo - la dinde
un milliard - mil milliones
amplia - large
tragar - avaler
encantador - ravissant
una fiera - un fauve
la selva - la jungle
un cordero - un mouton
lograr - reussir
la arena - le sable
acabar - finir
una averia - une panne
asustar - faire peur
extraviarse - se perdre
aconsejar - conseiller
desalentar - decouragé
un fracaso - un echec
agotador - epuisant
un oficio - un metier
un golpe - un coup
golpear - frapper
un rayo - un rayon
un retrato - un portrait
acosar - harceler
una carcajada - un sourir
una desgracia - un malheur
agregar - ajouter
fluir - couler
una estaca - un piquet
burlear - se moquer
una hoja - une feuille
envejecer - vieillir
conmoverse - emouvoir
tener ganas - avoir envie
aislarse - s’isoler
las raices - les racines
derrotar - vaincre
una pintora - une peintre
